111111111
1C00010C1
1P0100C11
100C0E001
111111111
