1111111
1C00011
1P01111
100C0E1
1111111
