111111111
1C00010C1
1P0111111
100C1E001
111111111
