11111111111
1000P110C11
1CC111000C1
10010001111
1C0001E0001
11111111111
