111111111111111
100011CC00101C1
1E01100P0110101
110000C11100001
10C010000001C01
111111111111111
