111111
1P01C1
100C01
1E1111
111111
