11111111
10CE1101
1C1110P1
1010C011
10001111
11111111