111111
1P0101
100C01
1E1111
111111
