1111111111
10P0CC001E
1111100011
1111111111
