11111111
1P0E0CC1
1000111
11111111
